....................
....................
....................
....................
.....##############.
..................#.
..................#.
..................#.
..................#.
..................#.
..................#.
..................#.
..................#.
..................#.
..................#.
..................#.
..................#.
....................
....................
....................