....................
....................
....................
....................
.....##############.
.....#............#.
.....#............#.
.....#............#.
.....#............#.
.....#............#.
.....#............#.
.....#............#.
.....#............#.
.....#............#.
.....#............#.
.....#............#.
.....#............#.
....................
....................
....................